11111111111111111111111111111111111
1P00000000010000000100CC00010000001
10001100001000000011100000010000111
101000C0000010010000C00110000000001
111000100000C0C00100010000101110011
10000000110000010000000011100000001
101100010001000000E0000100100011011
1011000100C01000100000100C001100101
10100101001000001010010000000101001
10100100101010100010010000000101001
100000000C00C0000000000000000000C11
11111111111111111111111111111111111