11111111111111111111111111111111111111111111
1P00000X00010000000100CC00010001000000010001
10001100001000000011100000010000110000001001
101000C0000010010000C00110000000000011010X01
111000100000C0C00100010000101110010000010001
10000000110000010000C00011100000000001100001
101100010001000000E0000100100011010000000001
1011000100C01000100000100C0011001000C000C001
10100101001000001010010000000101001100010001
1010010010101010001001000E00010000001000X001
100000000C00C0000000C0C000X00000C100000C0101
111000100000C0C00100010000101110010011000001
10000000110000010000000011100000C0000C00C001
10001100001000X00011100000010000110001110001
11111111111111111111111111111111111111111111