1111111111111111111111111111111111
10P00001110000C000010000C00X001001
101100000100100CC0011000C0001100E1
100X00100000C00X010000110X00000001
1111111111111111111111111111111111