1111111111111111111111111111111111
100000E0000C000C00000C0000C0110001
1010010100100000101001000010010101
1010010010101010001001000000010101
100000000C00C000000000P000000000C1
1111111111111111111111111111111111